最近一班从宝山校区（校本部）去延长校区的校车什么时候到？	校车	1
最近一班从宝山校区（校本部）去嘉定校区的校车什么时候到？	校车	1
最近一班从延长校区去宝山校区（校本部）的校车什么时候到？	校车	1
最近一班从延长校区去嘉定校区的校车什么时候到？	校车	1
最近一班从嘉定校区去宝山校区（校本部）的校车什么时候到？	校车	1
最近一班从嘉定校区去延长校区的校车什么时候到？	校车	1
下一班从宝山校区（校本部）去延长校区的校车什么时候出发？	校车	1
下一班从宝山校区（校本部）去嘉定校区的校车什么时候出发？	校车	1
下一班从延长校区去宝山校区（校本部）的校车什么时候出发？	校车	1
下一班从延长校区去嘉定校区的校车什么时候出发？	校车	1
下一班从嘉定校区去宝山校区（校本部）的校车什么时候出发？	校车	1
下一班从嘉定校区去延长校区的校车什么时候出发？	校车	1
从宝山校区（校本部）去延长校区的校车什么时候能到？	校车	1
从宝山校区（校本部）去嘉定校区的校车什么时候能到？	校车	1
从延长校区去宝山校区（校本部）的校车什么时候能到？	校车	1
从延长校区去嘉定校区的校车什么时候能到？	校车	1
从嘉定校区去宝山校区（校本部）的校车什么时候能到？	校车	1
从嘉定校区去延长校区的校车什么时候能到？	校车	1
[秋季/冬季]学期校车的发车时间都有哪些？	校车	2
学期校车的发车时间都有哪些？	校车	2
春季学期校车的发车时间都有哪些？	校车	2
夏季学期校车的发车时间都有哪些？	校车	2
工作日校车的发车时间都有哪些？	校车	2
双休日校车的发车时间都有哪些？	校车	2
暑期校车的发车时间都有哪些？	校车	2
从宝山校区（校本部）去嘉定校区的校车一般几点出发？	校车	2
从宝山校区（校本部）去延长校区的校车一般几点出发？	校车	2
从嘉定校区去宝山校区（校本部）的校车一般几点出发？	校车	2
从嘉定校区去延长校区的校车一般几点出发？	校车	2
从延长校区去宝山校区（校本部）的校车一般几点出发？	校车	2
从延长校区去嘉定校区的校车一般几点出发？	校车	2
校园网有哪些？	校园网	1
Shu(ForAll)怎么连接？	校园网	2
ShuWlan-1X怎么连接？	校园网	3
eduroam怎么连接？	校园网	4
校园网怎么连接？	校园网	5
校园网为什么连不上？	校园网	6
学校附近有哪些地方可以取现啊？	银行、ATM	1
附近有哪些银行或者ATM？	银行、ATM	2
学校有哪些地方有快递点呢？	快递	1
哪里可以寄快递呢	快递	1
菜鸟驿站有那些快递公司呢	快递	2
我的圆通快递在哪取呢	快递	3
我的韵达快递在哪取呢	快递	3
我的京东快递在哪取呢	快递	3
我的万象快递在哪取呢	快递	3
我的申通快递在哪取呢	快递	3
我的中通快递在哪取呢	快递	3
我的国通快递在哪取呢	快递	3
我的天天快递在哪取呢	快递	3
我的百世快递在哪取呢	快递	3
我的快递地址怎么填呢	快递	4
学校哪里有打印店	打印店	1
请问打印店价格是多少	打印店	2
距离我最近的打印店在哪	打印店	3
校内有打印店吗	打印店	4
新世纪有打印店吗	打印店	4
东区有打印店吗	打印店	4
南区有打印店吗	打印店	4
如何迁户口	在校事务	1
如何办理成绩证明	在校事务	2
如何办理在读证明	在校事务	3
校医院工作时间	校医院	1
校医院哪些科室上班	校医院	2